+-+-+-+-+-+-+-+
| |   |   |   |
+ + +-+-+ + +-+
| | | | | |   |
+ + + + + +-+ +
|   | |   |   |
+ +-+ +-+ + +-+
|   |   | | | |
+ +-+ +-+ + + +
| | | |     | |
+ + + +-+-+ + +
|       |     |
+-+ +-+-+-+-+ +
|             |
+-+-+-+-+-+-+-+