+-+-+-+-+
| | |   |
+ + + +-+
|   | | |
+-+ + + +
|   |   |
+ +-+ +-+
| |     |
+ +-+-+ +
|       |
+-+-+-+-+