+-+-+-+-+-+-+-+-+-+-+
|     | | |   |   | |
+ +-+ + + +-+ +-+ + +
| | | | |           |
+ + + + + +-+-+-+ +-+
| | |         | | | |
+ + +-+-+-+-+ + + + +
|   | | | |     |   |
+ +-+ + + +-+ +-+-+ +
| | |   |   | | | | |
+ + + +-+-+ + + + + +
|       | | | |     |
+-+ +-+-+ + + +-+-+ +
| | |     | | | | | |
+ + +-+ +-+ + + + + +
|   | | | | |     | |
+ +-+ + + + + +-+ +-+
|   | |   | | | | | |
+-+ + + +-+ + + + + +
|           |   |   |
+-+-+-+-+-+-+-+-+-+-+