+-+-+-+-+-+-+-+-+-+-+
|       |   |   |   |
+-+-+ +-+ +-+-+ +-+ +
|   | | | | |     | |
+-+ + + + + + +-+ + +
| |     |     |     |
+ + +-+ +-+-+ +-+-+ +
| |   | | |   |     |
+ + +-+ + + +-+-+-+-+
| |   |     | | |   |
+ +-+-+-+ +-+ + + +-+
| | |   |   | |   | |
+ + + +-+ +-+ + +-+ +
|   |     |         |
+-+ +-+ +-+-+-+ +-+-+
| | |   |     |   | |
+ + + +-+-+ +-+-+ + +
| |       |   | | | |
+ + +-+ +-+ +-+ + + +
|     |             |
+-+-+-+-+-+-+-+-+-+-+
